
DiffCSAB/CSJC_A1.xml	CSJC_A
DiffCSAB/CSJC_B1.xml	CSJC_B
DiffCSCD/CSJC_C1.xml	CSJC_C
DiffCSCD/CSJC_D1.xml	CSJC_D

DiffCSAB/CSTP_A1.xml	CSTP_A
DiffCSAB/CSTP_B1.xml	CSTP_B
DiffCSCD/CSTP_C1.xml	CSTP_C
DiffCSCD/CSTP_D1.xml	CSTP_D

DiffCSAB/CSBvS_A1.xml	CSBvS_A
DiffCSAB/CSBvS_B1.xml	CSBvS_B
DiffCSCD/CSBvS_C1.xml	CSBvS_C
DiffCSCD/CSBvS_D1.xml	CSBvS_D

DiffCSAB/CSHS_A1.xml	CSHS_A
DiffCSAB/CSHS_B1.xml	CSHS_B
DiffCSCD/CSHS_C1.xml	CSHS_C
DiffCSCD/CSHS_D1.xml	CSHS_D

DiffCSAB/CSTZ_A1.xml	CSTZ_A
DiffCSAB/CSTZ_B1.xml	CSTZ_B
DiffCSCD/CSTZ_C1.xml	CSTZ_C
DiffCSCD/CSTZ_D1.xml	CSTZ_D

DiffCSAB/CSJC_A2.xml	CSJC_A
DiffCSAB/CSJC_B2.xml	CSJC_B

DiffCSCD/CSJC_D2.xml	CSJC_D

DiffCSAB/CSTP_A2.xml	CSTP_A
DiffCSAB/CSTP_B2.xml	CSTP_B
DiffCSCD/CSTP_C2.xml	CSTP_C


DiffCSAB/CSBvS_A2.xml	CSBvS_A
DiffCSAB/CSBvS_B2.xml	CSBvS_B


DiffCSAB/CSTZ_A2.xml	CSTZ_A
DiffCSAB/CSTZ_B2.xml	CSTZ_B
DiffCSCD/CSTZ_C2.xml	CSTZ_C
DiffCSCD/CSTZ_D2.xml	CSTZ_D


DiffCSAB/CSJC_A3.xml	CSJC_A
DiffCSAB/CSJC_B3.xml	CSJC_B
DiffCSCD/CSJC_C3.xml	CSJC_C
DiffCSCD/CSJC_D3.xml	CSJC_D

DiffCSAB/CSTP_A3.xml	CSTP_A
DiffCSAB/CSTP_B3.xml	CSTP_B
DiffCSCD/CSTP_C3.xml	CSTP_C
DiffCSCD/CSTP_D3.xml	CSTP_D

DiffCSAB/CSBvS_A3.xml	CSBvS_A
DiffCSAB/CSBvS_B3.xml	CSBvS_B
DiffCSCD/CSBvS_C3.xml	CSBvS_C
DiffCSCD/CSBvS_D3.xml	CSBvS_D

DiffCSAB/CSHS_A3.xml	CSHS_A
DiffCSAB/CSHS_B3.xml	CSHS_B
DiffCSCD/CSHS_C3.xml	CSHS_C
DiffCSCD/CSHS_D3.xml	CSHS_D

DiffCSAB/CSTZ_A3.xml	CSTZ_A
DiffCSAB/CSTZ_B3.xml	CSTZ_B
DiffCSCD/CSTZ_C3.xml	CSTZ_C
DiffCSCD/CSTZ_D3.xml	CSTZ_D


DiffCSAB/CSJC_A4.xml	CSJC_A
DiffCSAB/CSJC_B4.xml	CSJC_B

DiffCSCD/CSJC_D4.xml	CSJC_D

DiffCSAB/CSTP_A4.xml	CSTP_A
DiffCSAB/CSTP_B4.xml	CSTP_B
DiffCSCD/CSTP_C4.xml	CSTP_C
DiffCSCD/CSTP_D4.xml	CSTP_D

DiffCSAB/CSBvS_A4.xml	CSBvS_A
DiffCSAB/CSBvS_B4.xml	CSBvS_B
DiffCSCD/CSBvS_C4.xml	CSBvS_C
DiffCSCD/CSBvS_D4.xml	CSBvS_D

DiffCSAB/CSHS_A4.xml	CSHS_A
DiffCSAB/CSHS_B4.xml	CSHS_B
DiffCSCD/CSHS_C4.xml	CSHS_C
DiffCSCD/CSHS_D4.xml	CSHS_D


DiffCSCD/CSBvS_D5.xml	CSBvS_D
DiffCSCD/CSTP_C5.xml	CSTP_C


DiffCS1st/CSTP_1.xml	CS_TP
DiffCS1st/CSTZ_1.xml	CS_TZ
DiffCS1st/CSHS_1.xml	CS_HS
DiffCS1st/CSbvs_1.xml	CS_bvs
DiffCS1st/CSJC_1.xml	CS_JC

DiffCS1st/CSTP_2.xml	CS_TP
DiffCS1st/CSTZ_2.xml	CS_TZ
DiffCS1st/CSHS_2.xml	CS_HS
DiffCS1st/CSbvs_2.xml	CS_bvs
DiffCS1st/CSJC_2.xml	CS_JC

DiffCS1st/CSTP_3.xml	CS_TP
DiffCS1st/CSTZ_3.xml	CS_TZ
DiffCS1st/CSHS_3.xml	CS_HS
DiffCS1st/CSbvs_3.xml	CS_bvs
DiffCS1st/CSJC_3.xml	CS_JC

DiffCS1st/CSTP_4.xml	CS_TP
DiffCS1st/CSTZ_4.xml	CS_TZ
DiffCS1st/CSHS_4.xml	CS_HS
DiffCS1st/CSbvs_4.xml	CS_bvs
DiffCS1st/CSJC_4.xml	CS_JC

DiffCS1st/CSTP_5.xml	CS_TP
DiffCS1st/CSTZ_5.xml	CS_TZ
DiffCS1st/CSHS_5.xml	CS_HS
DiffCS1st/CSbvs_5.xml	CS_bvs
DiffCS1st/CSJC_5.xml	CS_JC

DiffCS1st/CSTP_6.xml	CS_TP
DiffCS1st/CSTZ_6.xml	CS_TZ
DiffCS1st/CSHS_6.xml	CS_HS
DiffCS1st/CSbvs_6.xml	CS_bvs
DiffCS1st/CSJC_6.xml	CS_JC

DiffCS1st/CSTP_7.xml	CS_TP
DiffCS1st/CSTZ_7.xml	CS_TZ
DiffCS1st/CSHS_7.xml	CS_HS
DiffCS1st/CSbvs_7.xml	CS_bvs
DiffCS1st/CSJC_7.xml	CS_JC

DiffCS1st/CSTP_8.xml	CS_TP
DiffCS1st/CSTZ_8.xml	CS_TZ
DiffCS1st/CSHS_8.xml	CS_HS
DiffCS1st/CSbvs_8.xml	CS_bvs
DiffCS1st/CSJC_8.xml	CS_JC



DiffCS1st/CSTZ_9.xml	CS_TZ
DiffCS1st/CSHS_9.xml	CS_HS
DiffCS1st/CSbvs_9.xml	CS_bvs
DiffCS1st/CSJC_9.xml	CS_JC

DiffCS1st/CSTP_10.xml	CS_TP
DiffCS1st/CSTZ_10.xml	CS_TZ
DiffCS1st/CSHS_10.xml	CS_HS
DiffCS1st/CSbvs_10.xml	CS_bvs
DiffCS1st/CSJC_10.xml	CS_JC

DiffCS1st/CSTZ_11.xml	CS_TZ
DiffCS1st/CSHS_11.xml	CS_HS
DiffCS1st/CSbvs_11.xml	CS_bvs
DiffCS1st/CSJC_11.xml	CS_JC
DiffCS1st/CSTP_11.xml	CS_TP

DiffCS1st/CSTP_12.xml	CS_TP
DiffCS1st/CSTZ_12.xml	CS_TZ
DiffCS1st/CSHS_12.xml	CS_HS
DiffCS1st/CSbvs_12.xml	CS_bvs
DiffCS1st/CSJC_12.xml	CS_JC


